%%%%%%%%%%%%%%%%%%%
% .           ....%
%.% % %%%%%% %.%%.%
%.%o% %   .% %.o%.%
%.%%%.%  %%% %..%.%
%.....  P    %..% %
%%%%%%%%%%%%%%%%%%%%
